0DS0000000000
00000I0000000
0D00000000000
00IIIIIII0000
00000I0000000
0D00010E00000
000EIIIII0000
0000000000000
0IIII00000000
000E000S00000
I000000000000
0I000S0000000
00I0000000000