IIIIIIIIIIIII
00000I0000000
IIIIIIIIIIIII
0000000000000
00I00I00I0000
0000000000000
0000000000000
0I00I00I00000
0000000000000
0000000000000
0000000000000
0000000000000
0000000000000
