0000000000000
00000I0000000
0000000000000
00IIIIIII0000
00000I0000000
0S00000000000
0000IIIII0000
0000000000000
0IIII00000000
0000000000000
0000000000000
0000000000000
0000000000000
