0DS0000000000
0D000I0000000
0D00000000000
00IIIIIII0000
00000I0000000
0000000E00000
0000IIIII0000
0000000000000
0IIII00000000
0000000000000
I000000000000
0I00000000000
00I0000000000