IIIIIIIIIIIII
00000I0000000
IIIIIIIIIIIII
0000000000000
0000000000000
0000000000000
0000000000000
0000000000000
0000000000000
0000000000000
0000000000000
0000000000000
0000000000000
