0000000000000
0000000000000
0000000000000
0000000000000
0000000000000
0000001000000
0000000000000
0000D00D00D00
0000000000000
0000E00E00E00
0000000000000
0000S00000S00
0000000000000