IIIIIIIIIIIII
I0S0000000S0I
I0II0DE00II0I
I00000000000I
I0IIIIIIIII0I
I00000000000I
I0000DE01I00I
I00000000000I
I0IIIIIIIII0I
I00000000000I
I0II0DE00II0I
I0S0000000S0I
IIIIIIIIIIIII