IIIIIIIIIIIII
I0S0000000S0I
I0EE0DI00EE0I
I00000000000I
I0IIIIIIIII0I
I00000000000I
I0000DI01I00I
I00000000000I
I0IIIIIIIII0I
I00000000000I
I0EE0DI00EE0I
I0S0000000S0I
IIIIIIIIIIIII