SIIIIIIIIIIIS
00000III00000
IIIIIIIIIIIII
00000III00000
0E000III000E0
000IIIIII0000
0000000000000
000II12III000
0E000III000E0
00000III00000
IIIIIIIIIIIII
00000III00300
SIIIIIIIIIIIS
