0000000000000
000000I00S000
000000I000000
0000EIII00D00
0IIIIIIIIIII0
0000000000000
00100D0000D30
0000000000000
0IIIIIIIIIII0
00000IIIE0000
000000I000000
000000I00S000
0000000000000